SO xpm/so.xpm
WE xpm/we.xpm
EA xpm/ea.xpm
NO xpm/no.xpm

F 89,89,89
C 5,125,150

        111111111111111111111111
        1000000000000000000000001
        10000000000N0000000000001
        1000000000010000000000001
111111111000000010000000000000001
100000000011000000000111111111111
11110111111111011100000010001
11110111111111011101010010001
11000000110101011100000010001
10000000000000001100000010001
10000000000000001101010010001
110000011101010111110111100111
11110111 1110101 101111010001
11111111 1111111 111111111111
